Pick up all the water drops and reach the exit in time.
....................
.................X..
..........##########
....................
WWW....WWWW.........
---....####.........
....................
WWW...........P.....
###.........WWWWW...
............#####...
....WWW.............
....###.............
.....P..............
.1........W.W.W.W.W.
####################
timer=40