Avoid the rockets! You can jump through some platforms.
....................
r...............X...
.----..W.......--..W
....W.--..........##
...--....-----......
r................W.W
.......W.P..W..#####
....W..######.......
....................
-----..........-----
....................
W.W.............W..R
---............-----
.1...W..W..W..W.W.W.
###..#..#..#..######